##########
#R###### #
# ###    #
#     ####
# ########
# ###   ##
#     ####
# ##### G#
#        #
##########
